R   120 30
NO  ./path_to_the_north_texture
SO  ./path_to_the_south_texture
WE  ./path_to_the_est_texture
S   ./path_to_the_sprite_texture
F   220,100,0
C   225,30,2
EA  ./path_to_the_east_texture






11111111111111111111111111111111111111111111
10000001100000000011000000000000111111111111
10000001101100000111000000200000000000000001
10000001100100000000000000000000111101111101
10000001101100000111000000000000111101111101
10000000001100000111011111011101111101111101
11110111111111011100000010001101111101111101
11110111101111011101010010001100000000000001
11000000110101011100000010001111111001111101
10002000000000001100000010001111111101111101
10000000S00000001101010010001111111101111101
11000001110101011111011110000000000000111101
11110111111101011101111010000000000000000001
11111111111111111111111111111111111111111111