R 1920 10
NO ./path_to_the_north_texture
SO ./path_to_the_south_texture
WE ./path_to_the_est_texture
S ./path_to_the_sprite_texture
F 220,100,0
C 225,30,2
EA ./path_to_the_east_texture




 111111111111111111111111
1000000000110000000000001 111
11
1111111111111111111111111 
1211000001110000000000001
100100000000000000000001
111111111011000001110000000000001
100000000011000001110111111111111    
111101111111110111000S0010001
11110111111111011101010010001
11000000110101011100000010001
10002000000000001100000010001

1000000000000000101010010001
110000011101010111110111100111
11110111 1110101 101111010001
11110111111111011100000010001
11110111111111011101010010001
1100000011010101100000010001





1000000000000000101010010001
   