R   120 30
NO  ./path_to_the_north_texture
SO  ./path_to_the_south_texture
WE  ./path_to_the_est_texture
S   ./path_to_the_sprite_texture
F   220,100,0
C   225,30,2
EA  ./path_to_the_east_texture

  111                                                   1111111111111111111111111111111111111111111
  101                                                   1000000000000000000000000000000000000000001
  111                                                   10000000000000000000000000000000000000000001
                                                        100000000000000000000000000000000000000000001
              1111111  111111111111111111111            1000000000000000000000000000000000000000000001
           1111100001  100011111000000001001            10000000000000000000000000000000000000000000001
        1111100000001  100000011110111111101            100000000000000000000000000000000000000000000001
  1111111100000000001  10000000000011    101            1000000000000000000000000000000000000000000000001
  1000000000000000001  10000000000111   11011111111     10000000000000000000000000S00000000000000000000001
  1100000000000000001  10000000000001   11000000001     100000000000000000000000000000000000000000000000001
  1111111111111111111  11111110111111   11111111101     1000000000000000000000000020000000000000000000000001
                            10001               101     10000000000000000000000002120000000000000000000000001
  11111111111111111     111110001111111111111   101111  100000000000000000000000211120000000000000000000000001
 111000000000000011    1100000000000000000001   100001  10000000000000000000000211 1120000000000000000000000001
  10000000000000001    1000000000000000000001   1100011 1000000000000000000000211   1120000000000000000000000001 
  11000000000000011    1100000000000111110001   1000001 10000000000000000000000211 1120000000000000000000000001
  1000000000000001      1000000000001   10001   1000001 100000000000000000000000211120000000000000000000000001
  11100000000000011111111000000000001   10001   1100001110000000000000000000000002120000000000000000000000001
   1111000000000000001000000000000001   10001  1110000000000000000000000000000000020000000000000000000000001
   1100000000000000000000000001111111   11111  100011111100000000000000000000000000000000000000000000000001
   11111000001100000000000000000001            10001    10000000000000000000000000000000000000000000000001
 111000000000000000000000000001111111111111111110001    1000000000000000000000000000000000000000000000001
 111111000000000000000000000000000000000000000000001    100000000000000000000000000000000000000000000001
     11111100000000000000000011111111111111111000001    10000000000000000000000000000000000000000000001
         1111110000000000111111            111111111    1000000000000000000000000000000000000000000001
             11111111111111                             100000000000000000000000000000000000000000001
                                                        10000000000000000000000000000000000000000001
                                                        1000000000000000000000000000000000000000001
                                                        111111111111111111111111111111111111111111